00,00,00,00,00,00,00,00,00,00
00,00,00,00,00,00,00,00,00,00
00,00,00,12,11,00,00,00,00,00
00,00,00,00,10,18,19,00,00,00
00,00,00,00,09,00,20,00,00,00
00,00,00,00,08,00,00,00,00,00
00,00,00,00,07,00,06,00,00,00
00,00,14,13,03,04,05,00,00,00
00,00,15,00,02,00,17,00,00,00
00,00,16,00,01,00,00,00,00,00
